1111111111111111111111111
1010000010101000001010101
1121101210101111101010101
1020000000000000001010101
1011101011111210111012111
1010101000100010000000001
1020101010122110111011111
1010000010000010001000002
1110121110111011101111101
1000100000100010001000101
1011111110111010101011111
2000101010000000101000002
1010101010101011101010101
1010100000101010100010101
1111111111111211111111111
